{
  "height": 10,
  "width": 10,
  "tilewidth": 32,
  "tileheight": 32,
  "layers": [
    {
      "name": "ground",
      "width": 10,
      "height": 10,
      "data": [
        1,1,1,1,1,1,1,1,1,1,
        1,1,1,1,1,1,1,1,1,1,
        1,1,1,1,1,1,1,1,1,1,
        1,1,1,1,1,1,1,1,1,1,
        1,1,1,1,1,1,1,1,1,1,
        1,1,1,1,1,1,1,1,1,1,
        1,1,1,1,1,1,1,1,1,1,
        1,1,1,1,1,1,1,1,1,1,
        1,1,1,1,1,1,1,1,1,1,
        1,1,1,1,1,1,1,1,1,1
      ]
    },
    {
      "name": "collision",
      "width": 10,
      "height": 10,
      "data": [
        0,0,0,0,0,0,0,0,0,0,
        0,0,0,0,0,0,0,0,0,0,
        0,0,0,0,0,0,0,0,0,0,
        0,0,0,0,0,0,0,0,0,0,
        0,0,0,0,0,0,0,0,0,0,
        0,0,0,0,0,0,0,0,0,0,
        0,0,0,0,0,0,0,0,0,0,
        0,0,0,0,0,0,0,0,0,0,
        0,0,0,0,0,0,0,0,0,0,
        0,0,0,0,0,0,0,0,0,0
      ]
    }
  ]
}
